//MAP CONVERTED BY dmm2tgm.py THIS HEADER COMMENT PREVENTS RECONVERSION, DO NOT REMOVE
"a" = (
/obj/effect/turf_decal/trimline/white/filled/end{
	dir = 1
	},
/obj/machinery/atmospherics/components/unary/outlet_injector/on/layer4{
	dir = 4
	},
/turf/open/floor/engine/airless,
/area/ruin/powered)
"b" = (
/obj/machinery/atmospherics/pipe/smart/manifold4w/r_deepviolet/visible,
/obj/machinery/atmospherics/pipe/smart/manifold4w/r_chartreuse/visible/layer4,
/obj/machinery/atmospherics/pipe/smart/manifold4w/r_navy/hidden/layer2,
/obj/machinery/light/directional/west,
/turf/open/floor/iron/dark/small,
/area/ruin/powered)
"c" = (
/obj/effect/turf_decal/trimline/blue/filled/end{
	dir = 1
	},
/obj/machinery/atmospherics/components/unary/vent_pump/siphon/on/layer4{
	dir = 8
	},
/turf/open/floor/engine/airless,
/area/ruin/powered)
"d" = (
/obj/structure/window/reinforced/plasma/spawner/directional/south,
/obj/machinery/portable_atmospherics/canister,
/obj/machinery/atmospherics/components/unary/portables_connector/visible/layer4{
	dir = 8
	},
/turf/open/floor/iron/dark/small,
/area/ruin/powered)
"e" = (
/obj/machinery/atmospherics/pipe/smart/manifold4w/r_bldorng/visible/layer2,
/obj/machinery/atmospherics/components/trinary/filter/atmos/n2{
	dir = 1
	},
/obj/machinery/atmospherics/pipe/smart/manifold4w/supply/visible/layer4,
/turf/open/floor/iron/dark/small,
/area/ruin/powered)
"f" = (
/obj/machinery/atmospherics/pipe/smart/manifold4w/scrubbers/visible/layer4,
/turf/open/floor/iron/dark/small,
/area/ruin/powered)
"g" = (
/obj/machinery/atmospherics/components/trinary/mixer/airmix/inverse{
	dir = 8;
	piping_layer = 4
	},
/obj/structure/window/reinforced/plasma/spawner/directional/west,
/turf/open/floor/iron/dark/small,
/area/ruin/powered)
"h" = (
/obj/machinery/atmospherics/components/binary/pump/layer4{
	dir = 8
	},
/turf/open/floor/iron/dark/small,
/area/ruin/powered)
"k" = (
/obj/machinery/atmospherics/components/binary/pump/on{
	dir = 4;
	target_pressure = 4500
	},
/obj/structure/window/reinforced/plasma/spawner/directional/east,
/turf/open/floor/iron/dark/small,
/area/ruin/powered)
"m" = (
/obj/structure/window/reinforced/plasma/spawner/directional/west,
/obj/machinery/atmospherics/components/binary/pump/layer4{
	dir = 4
	},
/turf/open/floor/iron/dark/small,
/area/ruin/powered)
"n" = (
/obj/machinery/atmospherics/components/unary/outlet_injector/on/layer4{
	dir = 4
	},
/turf/open/floor/engine/airless,
/area/ruin/powered)
"o" = (
/obj/structure/window/reinforced/plasma/spawner/directional/south,
/obj/machinery/atmospherics/components/binary/pump/layer4{
	dir = 4
	},
/turf/open/floor/iron/dark/small,
/area/ruin/powered)
"p" = (
/obj/machinery/atmospherics/pipe/smart/manifold4w/supply/visible/layer4,
/obj/structure/window/reinforced/plasma/spawner/directional/east,
/turf/open/floor/iron/dark/small,
/area/ruin/powered)
"q" = (
/obj/effect/turf_decal/trimline/white/filled/end,
/obj/machinery/atmospherics/components/unary/vent_pump/siphon/on/layer2{
	dir = 8
	},
/turf/open/floor/engine/airless,
/area/ruin/powered)
"r" = (
/obj/machinery/atmospherics/components/binary/temperature_gate{
	dir = 8;
	max_temperature = 295;
	target_temperature = 293.15;
	minimum_temperature = 290
	},
/obj/machinery/atmospherics/pipe/smart/manifold4w/r_chartreuse/visible/layer4,
/obj/machinery/light_switch/directional/north,
/turf/open/floor/iron/dark/small,
/area/ruin/powered)
"s" = (
/obj/machinery/atmospherics/pipe/layer_manifold/r_bldorng/visible{
	dir = 4
	},
/obj/machinery/airalarm/directional/north,
/obj/machinery/light/directional/north,
/obj/machinery/atmospherics/components/binary/pump/layer4{
	dir = 8
	},
/turf/open/floor/iron/dark/small,
/area/ruin/powered)
"t" = (
/obj/machinery/atmospherics/pipe/smart/manifold4w/r_navy/hidden/layer2,
/turf/closed/wall,
/area/ruin/powered)
"u" = (
/obj/machinery/atmospherics/pipe/smart/manifold4w/scrubbers/visible/layer4,
/obj/structure/window/reinforced/plasma/spawner/directional/east,
/turf/open/floor/iron/dark/small,
/area/ruin/powered)
"v" = (
/obj/machinery/atmospherics/pipe/smart/manifold4w/r_deepviolet/visible,
/obj/machinery/atmospherics/pipe/smart/manifold4w/supply/visible/layer4,
/obj/machinery/atmospherics/pipe/smart/manifold4w/r_bldorng/visible/layer2,
/turf/open/floor/iron/dark/small,
/area/ruin/powered)
"w" = (
/obj/machinery/atmospherics/pipe/smart/manifold4w/pink/visible/layer4,
/obj/structure/window/reinforced/plasma/spawner/directional/west,
/turf/open/floor/iron/dark/small,
/area/ruin/powered)
"y" = (
/obj/machinery/atmospherics/components/binary/pump/on{
	dir = 1
	},
/obj/machinery/atmospherics/pipe/smart/manifold4w/scrubbers/visible/layer4,
/obj/machinery/atmospherics/components/unary/vent_scrubber/on/layer2,
/turf/open/floor/iron/dark/small,
/area/ruin/powered)
"z" = (
/obj/machinery/atmospherics/components/unary/outlet_injector/on{
	dir = 8
	},
/obj/effect/turf_decal/trimline/red/filled/end,
/turf/open/floor/engine/airless,
/area/ruin/powered)
"A" = (
/obj/structure/window/reinforced/spawner/directional/east,
/obj/structure/window/reinforced/spawner/directional/south,
/obj/structure/window/reinforced/spawner/directional/west,
/obj/machinery/atmospherics/components/unary/passive_vent,
/turf/open/floor/plating/prairie_world/planetary,
/area/ruin/powered)
"B" = (
/obj/machinery/atmospherics/components/trinary/filter/atmos/plasma,
/obj/machinery/atmospherics/pipe/smart/manifold4w/r_chartreuse/visible/layer4,
/obj/machinery/atmospherics/pipe/smart/manifold4w/r_navy/hidden/layer2,
/turf/open/floor/iron/dark/small,
/area/ruin/powered)
"C" = (
/obj/effect/turf_decal/trimline/blue/filled/end,
/obj/machinery/atmospherics/components/unary/outlet_injector/on{
	dir = 8
	},
/turf/open/floor/engine/airless,
/area/ruin/powered)
"D" = (
/obj/effect/turf_decal/trimline/purple/filled/end{
	dir = 1
	},
/obj/machinery/atmospherics/components/unary/vent_pump/siphon/on/layer4{
	dir = 4
	},
/turf/open/floor/engine/airless,
/area/ruin/powered)
"E" = (
/turf/closed/wall,
/area/ruin/powered)
"F" = (
/obj/machinery/atmospherics/pipe/smart/manifold4w/r_deepviolet/visible,
/obj/machinery/atmospherics/components/unary/vent_pump/siphon/on/layer2{
	dir = 1
	},
/obj/machinery/light/directional/east,
/turf/open/floor/plating/prairie_world/planetary,
/area/ruin/powered)
"G" = (
/obj/machinery/atmospherics/pipe/smart/manifold4w/r_bldorng/visible/layer2,
/obj/machinery/atmospherics/pipe/smart/manifold4w/supply/visible/layer4,
/obj/machinery/atmospherics/pipe/bridge_pipe/scrubbers/visible/layer4,
/turf/open/floor/iron/dark/small,
/area/ruin/powered)
"H" = (
/obj/machinery/atmospherics/components/unary/vent_pump/siphon/on/layer4{
	dir = 4
	},
/turf/open/floor/engine/airless,
/area/ruin/powered)
"I" = (
/obj/machinery/atmospherics/components/unary/thermomachine/heater/on{
	piping_layer = 2
	},
/obj/structure/window/reinforced/spawner/directional/north,
/turf/open/floor/iron/dark/small,
/area/ruin/powered)
"K" = (
/obj/machinery/atmospherics/pipe/smart/manifold4w/r_bldorng/visible/layer2,
/obj/machinery/atmospherics/pipe/smart/manifold4w/r_deepviolet/visible,
/obj/machinery/atmospherics/pipe/smart/manifold4w/supply/visible/layer4,
/obj/machinery/light/directional/east,
/turf/open/floor/iron/dark/small,
/area/ruin/powered)
"M" = (
/obj/machinery/atmospherics/components/binary/pump/on{
	dir = 4;
	target_pressure = 4500
	},
/obj/structure/window/reinforced/plasma/spawner/directional/east,
/obj/structure/window/reinforced/plasma/spawner/directional/west,
/turf/open/floor/iron/dark/small,
/area/ruin/powered)
"N" = (
/obj/machinery/atmospherics/pipe/smart/manifold4w/r_deepviolet/visible,
/obj/machinery/atmospherics/components/unary/vent_pump/on/layer2,
/obj/machinery/atmospherics/components/binary/pump/layer4{
	dir = 4
	},
/turf/open/floor/iron/dark/small,
/area/ruin/powered)
"O" = (
/obj/structure/window/reinforced/plasma/spawner/directional/west,
/obj/structure/window/reinforced/plasma/spawner/directional/east,
/turf/open/floor/iron/dark/small,
/area/ruin/powered)
"P" = (
/obj/structure/window/reinforced/plasma/spawner/directional/west,
/obj/machinery/atmospherics/components/binary/pump/layer4{
	dir = 8
	},
/turf/open/floor/iron/dark/small,
/area/ruin/powered)
"Q" = (
/obj/effect/turf_decal/trimline/red/filled/end{
	dir = 1
	},
/obj/machinery/atmospherics/components/unary/vent_pump/siphon/on/layer4{
	dir = 8
	},
/turf/open/floor/engine/airless,
/area/ruin/powered)
"R" = (
/obj/machinery/atmospherics/pipe/smart/manifold4w/r_chartreuse/visible/layer4,
/turf/open/floor/iron/dark/small,
/area/ruin/powered)
"S" = (
/obj/machinery/atmospherics/pipe/smart/manifold4w/r_deepviolet/visible,
/turf/closed/wall,
/area/ruin/powered)
"T" = (
/obj/machinery/atmospherics/pipe/smart/manifold4w/r_deepviolet/visible,
/obj/machinery/atmospherics/pipe/smart/manifold4w/r_chartreuse/visible/layer4,
/obj/machinery/atmospherics/pipe/smart/manifold4w/r_navy/hidden/layer2,
/turf/open/floor/iron/dark/small,
/area/ruin/powered)
"U" = (
/obj/machinery/door/window/brigdoor{
	dir = 1
	},
/obj/machinery/door/window/brigdoor,
/obj/structure/fans/tiny,
/obj/machinery/atmospherics/components/trinary/filter/atmos/o2{
	dir = 1
	},
/obj/machinery/atmospherics/pipe/smart/manifold4w/r_bldorng/visible/layer2,
/turf/open/floor/iron/dark/small,
/area/ruin/powered)
"W" = (
/obj/machinery/atmospherics/components/binary/pump/on{
	dir = 8;
	target_pressure = 4500
	},
/obj/structure/window/reinforced/plasma/spawner/directional/west,
/turf/open/floor/iron/dark/small,
/area/ruin/powered)
"Y" = (
/obj/effect/turf_decal/trimline/purple/filled/end,
/obj/machinery/atmospherics/components/unary/outlet_injector/on{
	dir = 4
	},
/turf/open/floor/engine/airless,
/area/ruin/powered)
"Z" = (
/obj/machinery/atmospherics/pipe/smart/manifold4w/r_bldorng/visible/layer2,
/obj/machinery/atmospherics/pipe/smart/manifold4w/scrubbers/visible/layer4,
/turf/open/floor/iron/dark/small,
/area/ruin/powered)

(1,1,1) = {"
E
E
E
E
E
E
E
"}
(2,1,1) = {"
E
D
Y
E
n
H
E
"}
(3,1,1) = {"
E
w
W
E
P
m
E
"}
(4,1,1) = {"
E
N
B
b
T
T
S
"}
(5,1,1) = {"
E
r
R
o
E
t
S
"}
(6,1,1) = {"
E
s
h
d
a
q
S
"}
(7,1,1) = {"
I
Z
G
f
g
O
S
"}
(8,1,1) = {"
A
y
e
K
v
U
F
"}
(9,1,1) = {"
E
u
k
E
p
M
E
"}
(10,1,1) = {"
E
Q
z
E
c
C
E
"}
(11,1,1) = {"
E
E
E
E
E
E
E
"}
