//MAP CONVERTED BY dmm2tgm.py THIS HEADER COMMENT PREVENTS RECONVERSION, DO NOT REMOVE
"a" = (
/obj/effect/turf_decal/tile/yellow/half/contrasted{
	dir = 4
	},
/obj/item/gps/spaceruin{
	gpstag = "Public Holophone"
	},
/obj/machinery/light/small{
	dir = 1
	},
/obj/structure/window/reinforced/spawner/directional/west,
/turf/open/floor/plating/prairie_world/planetary,
/area/ruin/powered/icemoon_phone_booth)
"h" = (
/obj/machinery/airalarm/directional/south,
/obj/effect/turf_decal/tile/yellow/half/contrasted{
	dir = 4
	},
/obj/machinery/atmospherics/components/tank/air{
	dir = 8;
	piping_layer = 4
	},
/obj/structure/window/reinforced/spawner/directional/west,
/turf/open/floor/plating/prairie_world/planetary,
/area/ruin/powered/icemoon_phone_booth)
"k" = (
/obj/machinery/atmospherics/components/unary/vent_pump/on/layer4{
	dir = 4
	},
/turf/open/floor/iron/dark,
/area/ruin/powered/icemoon_phone_booth)
"n" = (
/obj/structure/lattice,
/turf/open/misc/asteroid/prairie_grass/planetary,
/area/ruin/powered/icemoon_phone_booth)
"s" = (
/obj/machinery/vending/cigarette{
	onstation_override = 1
	},
/obj/structure/window/reinforced/spawner/directional/east,
/turf/open/floor/plating/prairie_world/planetary,
/area/ruin/powered/icemoon_phone_booth)
"v" = (
/obj/effect/spawner/structure/window/hollow/reinforced,
/obj/machinery/atmospherics/components/binary/pump/layer2{
	dir = 1
	},
/turf/open/floor/plating/prairie_world/planetary,
/area/ruin/powered/icemoon_phone_booth)
"B" = (
/obj/machinery/holopad,
/obj/machinery/atmospherics/components/unary/vent_scrubber/on/layer2{
	dir = 1;
	widenet = 1
	},
/turf/open/floor/iron/dark/smooth_edge{
	dir = 1
	},
/area/ruin/powered/icemoon_phone_booth)
"C" = (
/obj/structure/lattice,
/obj/structure/billboard/Phone_booth,
/turf/open/misc/asteroid/prairie_grass/planetary,
/area/ruin/powered/icemoon_phone_booth)
"E" = (
/obj/machinery/atmospherics/components/unary/passive_vent/layer2,
/turf/open/misc/asteroid/prairie_grass/planetary,
/area/ruin/powered/icemoon_phone_booth)
"J" = (
/obj/machinery/door/window{
	dir = 1
	},
/obj/machinery/door/window,
/turf/open/floor/iron/dark/smooth_edge,
/area/ruin/powered/icemoon_phone_booth)
"K" = (
/obj/machinery/vending/coffee,
/obj/structure/window/reinforced/spawner/directional/east,
/turf/open/floor/plating/prairie_world/planetary,
/area/ruin/powered/icemoon_phone_booth)
"Q" = (
/turf/closed/wall/mineral/wood,
/area/ruin/powered/icemoon_phone_booth)

(1,1,1) = {"
C
Q
K
s
Q
"}
(2,1,1) = {"
E
v
B
k
J
"}
(3,1,1) = {"
n
Q
a
h
Q
"}
