//MAP CONVERTED BY dmm2tgm.py THIS HEADER COMMENT PREVENTS RECONVERSION, DO NOT REMOVE
"a" = (
/turf/open/misc/asteroid/prairie_grass/planetary,
/area/prairie_world/surface)
"B" = (
/obj/structure/elite_tumor,
/turf/open/misc/sandy_dirt/prairie,
/area/prairie_world/surface)
"E" = (
/turf/open/misc/sandy_dirt/prairie,
/area/prairie_world/surface)

(1,1,1) = {"
a
E
a
"}
(2,1,1) = {"
E
B
E
"}
(3,1,1) = {"
a
E
a
"}
