//MAP CONVERTED BY dmm2tgm.py THIS HEADER COMMENT PREVENTS RECONVERSION, DO NOT REMOVE
"a" = (
/obj/effect/spawner/structure/window/reinforced/shuttle,
/turf/open/floor/plating/airless,
/area/shuttle/arrival)
"f" = (
/obj/structure/chair/comfy/shuttle{
	dir = 8
	},
/obj/structure/extinguisher_cabinet/directional/east,
/turf/open/floor/mineral/titanium/white,
/area/shuttle/arrival)
"j" = (
/obj/machinery/power/shuttle_engine/propulsion/burst/right{
	dir = 4
	},
/obj/structure/window/reinforced/spawner/directional/north,
/obj/structure/window/reinforced/spawner/directional/south,
/turf/open/floor/plating/airless,
/area/shuttle/arrival)
"m" = (
/obj/structure/table,
/obj/item/storage/medkit/regular{
	pixel_y = 4
	},
/obj/item/storage/toolbox/emergency,
/turf/open/floor/mineral/titanium/white,
/area/shuttle/arrival)
"n" = (
/turf/template_noop,
/area/template_noop)
"B" = (
/obj/machinery/power/shuttle_engine/propulsion/burst/right{
	dir = 4
	},
/obj/structure/window/reinforced/spawner/directional/south,
/obj/structure/window/reinforced/spawner/directional/north,
/turf/open/floor/plating/airless,
/area/shuttle/arrival)
"C" = (
/obj/structure/chair/comfy/shuttle{
	dir = 8
	},
/turf/open/floor/mineral/titanium/white,
/area/shuttle/arrival)
"H" = (
/obj/structure/chair/comfy/shuttle{
	dir = 8
	},
/obj/structure/fireaxecabinet/directional/east,
/turf/open/floor/mineral/titanium/white,
/area/shuttle/arrival)
"J" = (
/obj/effect/spawner/structure/window/reinforced/shuttle,
/obj/docking_port/mobile/arrivals{
	name = "prairie arrivals shuttle"
	},
/turf/open/floor/plating/airless,
/area/shuttle/arrival)
"M" = (
/obj/machinery/power/shuttle_engine/heater{
	dir = 4
	},
/obj/structure/window/reinforced/spawner/directional/south,
/obj/structure/window/reinforced/spawner/directional/north,
/obj/structure/window/reinforced/spawner/directional/west,
/turf/open/floor/plating/airless,
/area/shuttle/arrival)
"Q" = (
/obj/structure/marker_beacon/burgundy,
/turf/closed/wall/mineral/titanium,
/area/shuttle/arrival)
"R" = (
/obj/structure/marker_beacon/olive,
/turf/closed/wall/mineral/titanium,
/area/shuttle/arrival)
"U" = (
/obj/machinery/power/shuttle_engine/heater{
	dir = 4
	},
/obj/structure/window/reinforced/spawner/directional/west,
/obj/structure/window/reinforced/spawner/directional/north,
/obj/structure/window/reinforced/spawner/directional/south,
/turf/open/floor/plating/airless,
/area/shuttle/arrival)
"V" = (
/obj/structure/closet/emcloset,
/obj/item/storage/medkit/o2,
/obj/item/tank/internals/emergency_oxygen,
/obj/item/clothing/mask/breath,
/obj/machinery/light/directional/east,
/turf/open/floor/mineral/titanium/white,
/area/shuttle/arrival)
"X" = (
/turf/open/floor/mineral/titanium/white,
/area/shuttle/arrival)
"Y" = (
/turf/closed/wall/mineral/titanium,
/area/shuttle/arrival)
"Z" = (
/obj/machinery/door/airlock/titanium{
	name = "Arrivals Shuttle Airlock"
	},
/obj/structure/fans/tiny,
/turf/open/floor/plating,
/area/shuttle/arrival)

(1,1,1) = {"
n
R
a
Q
n
"}
(2,1,1) = {"
Y
Y
m
Y
Y
"}
(3,1,1) = {"
Y
C
X
C
Y
"}
(4,1,1) = {"
Z
X
X
X
Z
"}
(5,1,1) = {"
R
H
V
f
Q
"}
(6,1,1) = {"
U
Y
J
Y
M
"}
(7,1,1) = {"
j
n
n
n
B
"}
