//MAP CONVERTED BY dmm2tgm.py THIS HEADER COMMENT PREVENTS RECONVERSION, DO NOT REMOVE
"a" = (
/turf/closed/wall/mineral/titanium,
/area/shuttle/supply)
"g" = (
/obj/machinery/light/directional/north,
/turf/open/floor/mineral/titanium,
/area/shuttle/supply)
"l" = (
/obj/machinery/door/airlock/titanium{
	name = "Supply Shuttle Airlock"
	},
/obj/structure/fans/tiny,
/turf/open/floor/plating,
/area/shuttle/supply)
"m" = (
/obj/structure/window/reinforced,
/obj/machinery/power/shuttle_engine/propulsion/burst/right{
	dir = 4
	},
/turf/open/floor/plating/airless,
/area/shuttle/supply)
"o" = (
/obj/machinery/light/directional/south,
/turf/open/floor/mineral/titanium,
/area/shuttle/supply)
"q" = (
/obj/structure/window/reinforced{
	dir = 4
	},
/turf/open/floor/mineral/titanium,
/area/shuttle/supply)
"s" = (
/obj/effect/turf_decal/trimline/nk006/sub_brown/filled/warning,
/obj/effect/turf_decal/arrows/red,
/turf/open/floor/mineral/titanium,
/area/shuttle/supply)
"u" = (
/obj/machinery/conveyor{
	dir = 1;
	id = "QMLoad2"
	},
/obj/effect/turf_decal/stripes/line{
	dir = 10
	},
/obj/machinery/door/poddoor{
	id = "QMLoaddoor2";
	name = "Supply Dock Loading Door"
	},
/turf/open/floor/mineral/titanium,
/area/shuttle/supply)
"v" = (
/obj/docking_port/mobile/supply{
	callTime = 300;
	port_direction = 2
	},
/turf/open/floor/plating/airless,
/area/shuttle/supply)
"y" = (
/obj/effect/turf_decal/trimline/nk006/sub_brown/filled/warning,
/obj/effect/turf_decal/arrows/red{
	dir = 1
	},
/turf/open/floor/mineral/titanium,
/area/shuttle/supply)
"A" = (
/obj/machinery/conveyor{
	id = "QMLoad"
	},
/obj/effect/turf_decal/stripes/line{
	dir = 9
	},
/obj/machinery/door/poddoor{
	id = "QMLoaddoor";
	name = "Supply Dock Loading Door"
	},
/turf/open/floor/mineral/titanium,
/area/shuttle/supply)
"G" = (
/obj/structure/marker_beacon/burgundy,
/turf/open/floor/plating/airless,
/area/shuttle/supply)
"I" = (
/obj/effect/turf_decal/trimline/nk006/sub_brown/filled/warning{
	dir = 1
	},
/obj/effect/turf_decal/arrows/red,
/turf/open/floor/mineral/titanium,
/area/shuttle/supply)
"L" = (
/turf/template_noop,
/area/template_noop)
"N" = (
/obj/machinery/button/door/directional/east{
	id = "QMLoaddoor2";
	name = "Loading Doors";
	pixel_y = 8
	},
/obj/machinery/button/door/directional/east{
	id = "QMLoaddoor";
	name = "Loading Doors";
	pixel_y = -8
	},
/turf/open/floor/mineral/titanium,
/area/shuttle/supply)
"O" = (
/turf/open/floor/mineral/titanium,
/area/shuttle/supply)
"R" = (
/obj/machinery/power/shuttle_engine/heater{
	dir = 4
	},
/obj/structure/window/reinforced,
/obj/structure/window/reinforced{
	dir = 8
	},
/turf/open/floor/plating/airless,
/area/shuttle/supply)
"S" = (
/obj/effect/turf_decal/trimline/nk006/sub_brown/filled/warning{
	dir = 1
	},
/obj/effect/turf_decal/arrows/red{
	dir = 1
	},
/turf/open/floor/mineral/titanium,
/area/shuttle/supply)
"U" = (
/obj/machinery/power/shuttle_engine/heater{
	dir = 4
	},
/obj/structure/window/reinforced{
	dir = 1
	},
/obj/structure/window/reinforced{
	dir = 8
	},
/turf/open/floor/plating/airless,
/area/shuttle/supply)
"V" = (
/obj/structure/marker_beacon/olive,
/turf/open/floor/plating/airless,
/area/shuttle/supply)
"Y" = (
/obj/structure/window/reinforced{
	dir = 1
	},
/obj/machinery/power/shuttle_engine/propulsion/burst/right{
	dir = 4
	},
/turf/open/floor/plating/airless,
/area/shuttle/supply)
"Z" = (
/obj/effect/spawner/structure/window/reinforced/shuttle,
/turf/open/floor/plating,
/area/shuttle/supply)

(1,1,1) = {"
L
Z
Z
Z
Z
Z
L
"}
(2,1,1) = {"
Z
O
O
O
O
O
Z
"}
(3,1,1) = {"
a
g
O
O
O
o
a
"}
(4,1,1) = {"
u
S
O
O
O
y
u
"}
(5,1,1) = {"
l
O
O
O
O
O
l
"}
(6,1,1) = {"
a
g
O
O
O
o
a
"}
(7,1,1) = {"
l
O
O
O
O
O
l
"}
(8,1,1) = {"
A
I
O
N
O
s
A
"}
(9,1,1) = {"
a
a
q
a
q
a
a
"}
(10,1,1) = {"
U
R
L
L
L
U
R
"}
(11,1,1) = {"
Y
m
G
v
V
Y
m
"}
