//MAP CONVERTED BY dmm2tgm.py THIS HEADER COMMENT PREVENTS RECONVERSION, DO NOT REMOVE
"a" = (
/obj/machinery/light/directional/south,
/turf/open/floor/mineral/titanium,
/area/shuttle/supply)
"e" = (
/obj/machinery/power/shuttle_engine/propulsion/burst/right{
	dir = 4
	},
/obj/structure/window/reinforced{
	dir = 1
	},
/obj/structure/window/reinforced,
/turf/open/floor/plating/airless,
/area/shuttle/supply)
"h" = (
/obj/structure/marker_beacon/burgundy,
/turf/open/floor/plating/airless,
/area/shuttle/supply)
"i" = (
/obj/structure/marker_beacon/yellow,
/obj/docking_port/mobile/supply{
	callTime = 300;
	port_direction = 2
	},
/turf/open/floor/plating/airless,
/area/shuttle/supply)
"j" = (
/obj/machinery/door/airlock/titanium{
	name = "Supply Shuttle Airlock"
	},
/turf/open/floor/plating,
/area/shuttle/supply)
"m" = (
/obj/machinery/power/shuttle_engine/propulsion/burst/left{
	dir = 4
	},
/obj/structure/window/reinforced{
	dir = 1
	},
/obj/structure/window/reinforced,
/turf/open/floor/plating/airless,
/area/shuttle/supply)
"x" = (
/obj/effect/turf_decal/trimline/nk006/sub_brown/filled/warning,
/turf/open/floor/mineral/titanium,
/area/shuttle/supply)
"z" = (
/obj/effect/turf_decal/trimline/nk006/sub_brown/filled/warning{
	dir = 1
	},
/turf/open/floor/mineral/titanium,
/area/shuttle/supply)
"C" = (
/obj/machinery/door/poddoor{
	id = "QMLoaddoor2";
	name = "Supply Dock Loading Door"
	},
/obj/machinery/conveyor{
	dir = 4;
	id = "QMLoad2"
	},
/obj/effect/turf_decal/stripes/line{
	dir = 10
	},
/turf/open/floor/mineral/titanium,
/area/shuttle/supply)
"D" = (
/turf/template_noop,
/area/template_noop)
"E" = (
/obj/structure/marker_beacon/olive,
/turf/open/floor/plating/airless,
/area/shuttle/supply)
"G" = (
/turf/template_noop,
/area/shuttle/supply)
"H" = (
/obj/effect/spawner/structure/window/reinforced/shuttle,
/turf/open/floor/plating,
/area/shuttle/supply)
"I" = (
/turf/closed/wall/mineral/titanium,
/area/shuttle/supply)
"K" = (
/obj/machinery/light/directional/north,
/turf/open/floor/mineral/titanium,
/area/shuttle/supply)
"M" = (
/obj/machinery/button/door/directional/east{
	id = "QMLoaddoor2";
	name = "Loading Doors";
	pixel_y = 8;
	pixel_x = 10
	},
/obj/machinery/button/door/directional/east{
	id = "QMLoaddoor";
	name = "Loading Doors";
	pixel_y = -8;
	pixel_x = 10
	},
/obj/structure/window/reinforced{
	dir = 4
	},
/turf/open/floor/mineral/titanium,
/area/shuttle/supply)
"Q" = (
/turf/open/floor/mineral/titanium,
/area/shuttle/supply)
"S" = (
/obj/machinery/door/poddoor{
	id = "QMLoaddoor";
	name = "Supply Dock Loading Door"
	},
/obj/machinery/conveyor{
	dir = 8;
	id = "QMLoad"
	},
/obj/effect/turf_decal/stripes/line{
	dir = 9
	},
/turf/open/floor/mineral/titanium,
/area/shuttle/supply)
"V" = (
/obj/effect/turf_decal/trimline/nk006/sub_brown/filled/warning{
	dir = 1
	},
/obj/structure/window/reinforced{
	dir = 4
	},
/turf/open/floor/mineral/titanium,
/area/shuttle/supply)
"W" = (
/obj/effect/turf_decal/trimline/nk006/sub_brown/filled/warning,
/obj/structure/window/reinforced{
	dir = 4
	},
/turf/open/floor/mineral/titanium,
/area/shuttle/supply)
"X" = (
/obj/machinery/power/shuttle_engine/heater{
	dir = 4
	},
/obj/structure/window/reinforced{
	dir = 8
	},
/obj/structure/window/reinforced{
	dir = 1
	},
/obj/structure/window/reinforced,
/turf/open/floor/plating/airless,
/area/shuttle/supply)

(1,1,1) = {"
D
H
H
H
D
"}
(2,1,1) = {"
I
Q
Q
Q
I
"}
(3,1,1) = {"
C
z
Q
x
C
"}
(4,1,1) = {"
j
Q
Q
Q
j
"}
(5,1,1) = {"
I
K
Q
a
I
"}
(6,1,1) = {"
j
Q
Q
Q
j
"}
(7,1,1) = {"
S
V
M
W
S
"}
(8,1,1) = {"
X
G
G
G
X
"}
(9,1,1) = {"
e
h
i
E
m
"}
