//MAP CONVERTED BY dmm2tgm.py THIS HEADER COMMENT PREVENTS RECONVERSION, DO NOT REMOVE
"bV" = (
/obj/machinery/light/directional/south,
/turf/open/floor/mineral/titanium/white,
/area/shuttle/escape)
"cL" = (
/obj/machinery/light/floor,
/obj/machinery/atmospherics/pipe/smart/manifold4w/r_chartreuse/hidden/layer4,
/turf/open/floor/mineral/titanium/blue,
/area/shuttle/escape)
"dI" = (
/turf/template_noop,
/area/template_noop)
"dX" = (
/obj/structure/chair/sofa/corp/right,
/turf/open/floor/mineral/titanium/white,
/area/shuttle/escape)
"dY" = (
/turf/closed/wall/mineral/titanium,
/area/shuttle/escape)
"eY" = (
/obj/effect/spawner/structure/window/reinforced/shuttle,
/obj/machinery/atmospherics/pipe/smart/manifold4w/r_bldorng/hidden/layer2,
/turf/open/floor/plating/airless,
/area/shuttle/escape)
"fe" = (
/obj/machinery/atmospherics/pipe/smart/manifold4w/r_chartreuse/hidden/layer4,
/obj/machinery/atmospherics/pipe/smart/manifold4w/r_bldorng/hidden/layer2,
/turf/open/floor/mineral/plastitanium/red,
/area/shuttle/escape)
"fx" = (
/obj/structure/chair/comfy/shuttle{
	dir = 8
	},
/obj/structure/window/reinforced/spawner/directional/east,
/turf/open/floor/mineral/titanium/white,
/area/shuttle/escape)
"fz" = (
/obj/machinery/door/airlock/titanium{
	name = "Emergency Shuttle Airlock"
	},
/obj/structure/fans/tiny,
/turf/open/floor/plating,
/area/shuttle/escape)
"it" = (
/obj/structure/window/reinforced/spawner/directional/east,
/obj/structure/chair/comfy/shuttle{
	dir = 8
	},
/turf/open/floor/mineral/titanium/white,
/area/shuttle/escape)
"jA" = (
/obj/machinery/atmospherics/components/unary/passive_vent/layer2{
	dir = 1
	},
/turf/open/floor/plating/airless,
/area/shuttle/escape)
"jI" = (
/obj/structure/window/reinforced/spawner/directional/north,
/obj/machinery/power/shuttle_engine/heater,
/obj/structure/window/reinforced/spawner/directional/east,
/turf/open/floor/plating/airless,
/area/shuttle/escape)
"li" = (
/obj/structure/window/reinforced/tinted/spawner/directional/south,
/obj/structure/window/reinforced/tinted/spawner/directional/east,
/obj/structure/chair/comfy/shuttle{
	dir = 1
	},
/obj/machinery/atmospherics/components/unary/vent_pump/on/layer4{
	dir = 8
	},
/turf/open/floor/mineral/titanium/white,
/area/shuttle/escape)
"nk" = (
/obj/structure/fans/tiny,
/obj/machinery/door/airlock/titanium{
	name = "Emergency Shuttle Airlock"
	},
/turf/open/floor/mineral/titanium/white,
/area/shuttle/escape)
"nY" = (
/obj/machinery/light/floor,
/obj/machinery/atmospherics/pipe/smart/manifold4w/r_chartreuse/hidden/layer4,
/turf/open/floor/mineral/plastitanium/red,
/area/shuttle/escape)
"pS" = (
/obj/structure/chair/sofa/corp,
/obj/machinery/atmospherics/pipe/smart/manifold4w/r_bldorng/hidden/layer2,
/turf/open/floor/mineral/titanium/white,
/area/shuttle/escape)
"rc" = (
/obj/machinery/firealarm/directional/south,
/turf/open/floor/mineral/titanium/white,
/area/shuttle/escape)
"sV" = (
/obj/machinery/door/airlock/titanium{
	name = "Emergency Shuttle Airlock"
	},
/obj/effect/mapping_helpers/airlock/access/all/security/general,
/obj/structure/fans/tiny,
/turf/open/floor/mineral/plastitanium/red,
/area/shuttle/escape)
"tt" = (
/obj/structure/window/reinforced/spawner/directional/north,
/obj/machinery/power/shuttle_engine/heater,
/obj/structure/window/reinforced/spawner/directional/west,
/turf/open/floor/plating/airless,
/area/shuttle/escape)
"ua" = (
/obj/machinery/power/shuttle_engine/propulsion,
/obj/structure/window/reinforced/spawner/directional/east,
/turf/open/floor/plating/airless,
/area/shuttle/escape)
"uj" = (
/obj/machinery/atmospherics/pipe/smart/manifold4w/r_chartreuse/hidden/layer4,
/obj/machinery/atmospherics/pipe/smart/manifold4w/r_bldorng/hidden/layer2,
/turf/open/floor/mineral/titanium/white,
/area/shuttle/escape)
"uy" = (
/obj/machinery/computer/emergency_shuttle,
/turf/open/floor/mineral/titanium/white,
/area/shuttle/escape)
"uP" = (
/obj/structure/window/reinforced/tinted/spawner/directional/south,
/obj/structure/window/reinforced/tinted/spawner/directional/west,
/obj/structure/chair/comfy/shuttle{
	dir = 1
	},
/obj/machinery/atmospherics/components/unary/vent_scrubber/on/layer2{
	dir = 4
	},
/turf/open/floor/mineral/titanium/white,
/area/shuttle/escape)
"uT" = (
/obj/structure/chair/comfy/shuttle{
	dir = 4
	},
/obj/structure/window/reinforced/spawner/directional/west,
/turf/open/floor/mineral/titanium/white,
/area/shuttle/escape)
"wi" = (
/obj/machinery/vending/wallmed/directional/west{
	use_power = 0
	},
/obj/machinery/light/directional/west,
/turf/open/floor/mineral/titanium/white,
/area/shuttle/escape)
"wX" = (
/obj/machinery/light/floor,
/obj/machinery/atmospherics/pipe/smart/manifold4w/r_bldorng/hidden/layer2,
/turf/open/floor/mineral/titanium/white,
/area/shuttle/escape)
"xa" = (
/obj/machinery/door/airlock/titanium{
	name = "Emergency Shuttle Airlock"
	},
/obj/docking_port/mobile/emergency{
	name = "PrairieOutpost emergency shuttle"
	},
/obj/structure/fans/tiny,
/turf/open/floor/plating,
/area/shuttle/escape)
"xd" = (
/obj/structure/chair/comfy/shuttle{
	dir = 8
	},
/obj/structure/window/reinforced/spawner/directional/east,
/obj/machinery/atmospherics/components/unary/vent_pump/on/layer4{
	dir = 8
	},
/turf/open/floor/mineral/titanium/white,
/area/shuttle/escape)
"yE" = (
/obj/machinery/light/directional/west,
/obj/structure/extinguisher_cabinet/directional/west,
/turf/open/floor/mineral/titanium/white,
/area/shuttle/escape)
"zg" = (
/turf/open/floor/mineral/plastitanium/red,
/area/shuttle/escape)
"Cd" = (
/obj/effect/spawner/structure/window/reinforced/shuttle,
/turf/open/floor/plating/airless,
/area/shuttle/escape)
"Ct" = (
/obj/machinery/light/floor,
/obj/machinery/atmospherics/pipe/smart/manifold4w/r_chartreuse/hidden/layer4,
/obj/machinery/atmospherics/pipe/smart/manifold4w/r_bldorng/hidden/layer2,
/turf/open/floor/mineral/titanium/white,
/area/shuttle/escape)
"Em" = (
/obj/machinery/stasis,
/turf/open/floor/mineral/titanium/blue,
/area/shuttle/escape)
"Es" = (
/obj/machinery/defibrillator_mount/directional/east,
/obj/structure/table/reinforced,
/obj/item/storage/backpack/duffelbag/med/surgery{
	pixel_y = 13
	},
/obj/item/storage/backpack/duffelbag/med/surgery,
/obj/machinery/atmospherics/components/unary/vent_scrubber/on/layer2{
	dir = 8
	},
/turf/open/floor/mineral/titanium/blue,
/area/shuttle/escape)
"EC" = (
/obj/machinery/suit_storage_unit/standard_unit,
/turf/open/floor/mineral/titanium/white,
/area/shuttle/escape)
"Fz" = (
/obj/machinery/atmospherics/pipe/smart/manifold4w/r_chartreuse/hidden/layer4,
/obj/machinery/atmospherics/pipe/smart/manifold4w/r_bldorng/hidden/layer2,
/turf/open/floor/mineral/titanium/blue,
/area/shuttle/escape)
"FW" = (
/obj/machinery/computer/crew,
/obj/structure/window/reinforced/tinted/spawner/directional/west,
/turf/open/floor/mineral/titanium/white,
/area/shuttle/escape)
"Gv" = (
/obj/structure/window/reinforced/tinted/spawner/directional/south,
/obj/structure/window/reinforced/tinted/spawner/directional/west,
/obj/structure/closet/crate/freezer/blood,
/turf/open/floor/mineral/titanium/blue,
/area/shuttle/escape)
"GJ" = (
/obj/structure/window/reinforced/tinted/spawner/directional/east,
/obj/structure/window/reinforced/tinted/spawner/directional/south,
/obj/structure/chair/comfy/shuttle{
	dir = 8
	},
/obj/machinery/atmospherics/components/unary/vent_scrubber/on/layer2{
	dir = 8
	},
/turf/open/floor/mineral/plastitanium/red,
/area/shuttle/escape)
"Ig" = (
/obj/machinery/atmospherics/pipe/smart/manifold4w/r_bldorng/hidden/layer2,
/obj/machinery/atmospherics/pipe/smart/manifold4w/r_chartreuse/hidden/layer4,
/turf/open/floor/mineral/titanium/blue,
/area/shuttle/escape)
"Ir" = (
/obj/structure/window/reinforced/tinted/spawner/directional/south,
/turf/open/floor/mineral/titanium/blue,
/area/shuttle/escape)
"Iv" = (
/obj/structure/closet/secure_closet/medical2,
/obj/item/storage/medkit/regular,
/obj/item/storage/medkit/fire,
/obj/item/storage/medkit/brute,
/obj/item/storage/medkit/o2,
/obj/item/storage/medkit/toxin,
/obj/item/storage/medkit/advanced,
/obj/item/defibrillator/loaded,
/obj/machinery/atmospherics/components/unary/vent_pump/on/layer4,
/obj/machinery/firealarm/directional/north,
/obj/machinery/airalarm/directional/east,
/turf/open/floor/mineral/titanium/blue,
/area/shuttle/escape)
"Jm" = (
/obj/structure/window/reinforced/tinted/spawner/directional/south,
/obj/structure/chair/comfy/shuttle{
	dir = 4
	},
/obj/machinery/flasher/directional/west{
	id = "shuttle_flasher"
	},
/obj/machinery/button/flasher{
	id = "shuttle_flasher";
	pixel_x = -24;
	pixel_y = -6
	},
/turf/open/floor/mineral/plastitanium/red,
/area/shuttle/escape)
"JX" = (
/obj/structure/chair/comfy/shuttle,
/obj/machinery/atmospherics/components/unary/vent_pump/on/layer4,
/obj/machinery/firealarm/directional/north,
/obj/machinery/airalarm/directional/west,
/turf/open/floor/mineral/plastitanium/red,
/area/shuttle/escape)
"Mn" = (
/obj/structure/window/reinforced/tinted/spawner/directional/south,
/obj/machinery/stasis,
/turf/open/floor/mineral/titanium/blue,
/area/shuttle/escape)
"MN" = (
/turf/open/floor/mineral/titanium/white,
/area/shuttle/escape)
"OP" = (
/obj/machinery/computer/communications,
/obj/structure/window/reinforced/tinted/spawner/directional/east,
/turf/open/floor/mineral/titanium/white,
/area/shuttle/escape)
"Pz" = (
/obj/machinery/light/floor,
/obj/machinery/door/window/brigdoor/left/directional/south{
	name = "Bridge";
	req_access = list("command")
	},
/obj/machinery/atmospherics/pipe/smart/manifold4w/r_chartreuse/hidden/layer4,
/obj/machinery/atmospherics/pipe/smart/manifold4w/r_bldorng/hidden/layer2,
/turf/open/floor/mineral/titanium/white,
/area/shuttle/escape)
"PI" = (
/obj/structure/window/reinforced/tinted/spawner/directional/east,
/obj/structure/chair/comfy/shuttle{
	dir = 8
	},
/turf/open/floor/mineral/plastitanium/red,
/area/shuttle/escape)
"QR" = (
/obj/structure/fireaxecabinet/directional/south,
/obj/machinery/light/directional/south,
/turf/open/floor/mineral/titanium/white,
/area/shuttle/escape)
"RH" = (
/obj/machinery/power/shuttle_engine/propulsion,
/obj/structure/window/reinforced/spawner/directional/west,
/turf/open/floor/plating/airless,
/area/shuttle/escape)
"Sc" = (
/obj/structure/window/reinforced/tinted/spawner/directional/west,
/obj/machinery/iv_drip,
/turf/open/floor/mineral/titanium/blue,
/area/shuttle/escape)
"Sm" = (
/obj/machinery/atmospherics/pipe/smart/manifold4w/r_chartreuse/hidden/layer4,
/turf/open/floor/mineral/titanium/white,
/area/shuttle/escape)
"TL" = (
/obj/structure/chair/sofa/corp/left,
/turf/open/floor/mineral/titanium/white,
/area/shuttle/escape)
"TM" = (
/obj/machinery/light/directional/east,
/obj/machinery/atmospherics/components/tank/air{
	dir = 8;
	piping_layer = 4
	},
/obj/machinery/airalarm/directional/east,
/turf/open/floor/mineral/titanium/white,
/area/shuttle/escape)
"Uh" = (
/obj/effect/spawner/structure/window/reinforced/shuttle,
/turf/open/floor/plating,
/area/shuttle/escape)
"VQ" = (
/obj/machinery/atmospherics/components/unary/vent_scrubber/on/layer2{
	dir = 4
	},
/turf/open/floor/mineral/titanium/white,
/area/shuttle/escape)
"Zv" = (
/obj/machinery/light/directional/east,
/obj/structure/extinguisher_cabinet/directional/east,
/turf/open/floor/mineral/titanium/white,
/area/shuttle/escape)

(1,1,1) = {"
dI
dI
dY
sV
dY
xa
dY
Uh
Uh
Uh
dY
fz
dY
fz
dY
"}
(2,1,1) = {"
dI
dY
dY
zg
Jm
VQ
wi
MN
MN
MN
yE
MN
MN
bV
dY
"}
(3,1,1) = {"
dY
dY
JX
nY
fe
uj
fx
fx
fx
fx
EC
rc
dY
tt
RH
"}
(4,1,1) = {"
Cd
FW
uP
PI
GJ
uj
uT
uT
uT
uT
dX
MN
Cd
jI
ua
"}
(5,1,1) = {"
Cd
uy
Pz
uj
uj
uj
Ct
uj
uj
uj
pS
wX
eY
jA
dI
"}
(6,1,1) = {"
Cd
OP
li
Sc
Fz
Gv
Sm
fx
xd
it
TL
MN
Cd
tt
RH
"}
(7,1,1) = {"
dY
dY
Iv
cL
Ig
Ir
Sm
uT
uT
uT
EC
rc
dY
jI
ua
"}
(8,1,1) = {"
dI
dY
dY
Em
Es
Mn
TM
MN
MN
MN
Zv
MN
nk
QR
dY
"}
(9,1,1) = {"
dI
dI
dY
Cd
dY
Cd
dY
Cd
Cd
Cd
dY
Cd
dY
fz
dY
"}
