//MAP CONVERTED BY dmm2tgm.py THIS HEADER COMMENT PREVENTS RECONVERSION, DO NOT REMOVE
"a" = (
/obj/effect/spawner/structure/window/reinforced/shuttle,
/turf/open/floor/plating,
/area/shuttle/escape)
"b" = (
/obj/machinery/power/shuttle_engine/heater{
	dir = 4
	},
/obj/structure/window/reinforced,
/obj/structure/window/reinforced{
	dir = 8
	},
/turf/open/floor/plating/airless,
/area/shuttle/escape)
"c" = (
/turf/template_noop,
/area/template_noop)
"d" = (
/obj/machinery/computer/emergency_shuttle{
	dir = 4
	},
/obj/effect/turf_decal/tile/nk006/department_sub_yellow/fourcorners,
/turf/open/floor/iron/dark/smooth_large,
/area/shuttle/escape)
"f" = (
/obj/structure/window/reinforced{
	dir = 4
	},
/obj/effect/turf_decal/tile/nk006/department_support/fourcorners,
/obj/machinery/recharge_station,
/turf/open/floor/iron/white/smooth_large,
/area/shuttle/escape)
"k" = (
/obj/structure/window/reinforced{
	dir = 8
	},
/obj/effect/turf_decal/tile/nk006/department_support/fourcorners,
/obj/structure/table/reinforced/titaniumglass,
/obj/item/storage/toolbox/electrical{
	pixel_y = 10
	},
/obj/item/storage/toolbox/mechanical{
	pixel_y = 4
	},
/obj/item/storage/toolbox/emergency{
	pixel_y = -2
	},
/obj/machinery/light/directional/north,
/obj/structure/fireaxecabinet/directional/east,
/turf/open/floor/iron/white/smooth_large,
/area/shuttle/escape)
"l" = (
/obj/structure/window/reinforced{
	dir = 1
	},
/obj/structure/window/reinforced{
	dir = 8
	},
/obj/structure/table/reinforced/titaniumglass,
/obj/item/storage/medkit/fire{
	pixel_x = -2;
	pixel_y = 4
	},
/obj/item/storage/medkit/brute{
	pixel_x = 3;
	pixel_y = 3
	},
/obj/item/storage/medkit/toxin{
	pixel_x = -3;
	pixel_y = -3
	},
/obj/item/storage/medkit/o2{
	pixel_y = -3;
	pixel_x = 8
	},
/obj/item/storage/medkit/advanced,
/obj/effect/turf_decal/tile/nk006/department_sub_red/fourcorners,
/turf/open/floor/iron/white,
/area/shuttle/escape)
"n" = (
/obj/machinery/power/shuttle_engine/heater{
	dir = 4
	},
/obj/structure/window/reinforced{
	dir = 1
	},
/obj/structure/window/reinforced{
	dir = 8
	},
/turf/open/floor/plating/airless,
/area/shuttle/escape)
"o" = (
/obj/structure/chair/comfy/shuttle{
	dir = 8
	},
/obj/item/radio/intercom/directional/south,
/turf/open/floor/iron,
/area/shuttle/escape)
"p" = (
/obj/machinery/light/directional/south,
/obj/structure/window/reinforced{
	dir = 4
	},
/obj/effect/turf_decal/trimline/nk006/sub_blue/filled/end,
/obj/structure/chair/comfy/shuttle/tactical{
	dir = 1
	},
/turf/open/floor/iron/dark,
/area/shuttle/escape)
"q" = (
/obj/structure/window/reinforced{
	dir = 4
	},
/obj/structure/chair/office{
	dir = 8
	},
/obj/effect/turf_decal/trimline/nk006/sub_yellow/filled/end,
/turf/open/floor/iron/dark/smooth_large,
/area/shuttle/escape)
"s" = (
/obj/structure/marker_beacon/burgundy,
/turf/open/floor/plating/airless,
/area/shuttle/escape)
"t" = (
/obj/machinery/door/window/right/directional/west{
	req_access = list("nk006_specialist")
	},
/obj/effect/turf_decal/trimline/nk006/sub_red/filled,
/turf/open/floor/iron/white,
/area/shuttle/escape)
"u" = (
/obj/docking_port/mobile/emergency{
	name = "Spacecraft emergency shuttle";
	port_direction = 2;
	preferred_direction = 2;
	dir = 8
	},
/turf/open/floor/plating/airless,
/area/shuttle/escape)
"w" = (
/obj/structure/chair/comfy/shuttle{
	dir = 8
	},
/turf/open/floor/iron,
/area/shuttle/escape)
"x" = (
/obj/machinery/door/airlock/titanium{
	name = "Supply Shuttle Airlock"
	},
/obj/structure/fans/tiny,
/turf/open/floor/plating,
/area/shuttle/escape)
"z" = (
/obj/machinery/computer/crew{
	dir = 4
	},
/obj/effect/turf_decal/tile/nk006/department_sub_yellow/fourcorners,
/turf/open/floor/iron/dark/smooth_large,
/area/shuttle/escape)
"A" = (
/obj/structure/chair/comfy/shuttle{
	dir = 8
	},
/obj/machinery/vending/wallmed/directional/north{
	use_power = 0
	},
/turf/open/floor/iron,
/area/shuttle/escape)
"C" = (
/obj/structure/window/reinforced{
	dir = 4
	},
/obj/structure/window/reinforced{
	dir = 1
	},
/obj/item/storage/medkit/surgery{
	pixel_y = 2
	},
/obj/machinery/computer/operating,
/obj/effect/turf_decal/tile/nk006/department_sub_red/fourcorners,
/turf/open/floor/iron/white,
/area/shuttle/escape)
"E" = (
/obj/structure/window/reinforced,
/obj/machinery/power/shuttle_engine/propulsion/burst/right{
	dir = 4
	},
/turf/open/floor/plating/airless,
/area/shuttle/escape)
"F" = (
/obj/structure/window/reinforced{
	dir = 8
	},
/obj/machinery/stasis,
/obj/effect/turf_decal/tile/nk006/department_sub_red/fourcorners,
/obj/machinery/iv_drip,
/obj/machinery/light/directional/south,
/turf/open/floor/iron/white,
/area/shuttle/escape)
"H" = (
/obj/structure/marker_beacon/olive,
/turf/open/floor/plating/airless,
/area/shuttle/escape)
"J" = (
/obj/structure/window/reinforced{
	dir = 1
	},
/obj/machinery/power/shuttle_engine/propulsion/burst/right{
	dir = 4
	},
/turf/open/floor/plating/airless,
/area/shuttle/escape)
"K" = (
/obj/effect/turf_decal/tile/nk006/department_sub_blue/fourcorners,
/obj/structure/table/reinforced/titaniumglass,
/obj/item/storage/box/zipties{
	pixel_x = 7
	},
/obj/machinery/recharger{
	pixel_x = -7
	},
/turf/open/floor/iron/dark,
/area/shuttle/escape)
"L" = (
/obj/structure/window/reinforced{
	dir = 1
	},
/obj/structure/chair/comfy/shuttle/tactical{
	dir = 4
	},
/obj/effect/turf_decal/tile/nk006/department_sub_blue/fourcorners,
/turf/open/floor/iron/dark,
/area/shuttle/escape)
"M" = (
/obj/structure/chair/comfy/shuttle{
	dir = 8
	},
/obj/structure/extinguisher_cabinet/directional/north,
/turf/open/floor/iron,
/area/shuttle/escape)
"N" = (
/turf/closed/wall/mineral/titanium,
/area/shuttle/escape)
"O" = (
/obj/machinery/computer/communications{
	req_access = list("nk006_head_any");
	capt_access = "nk006_head_cap";
	dir = 4
	},
/obj/effect/turf_decal/tile/nk006/department_sub_yellow/fourcorners,
/turf/open/floor/iron/dark/smooth_large,
/area/shuttle/escape)
"Q" = (
/obj/machinery/door/window/right/directional/west{
	req_access = list("nk006_support")
	},
/obj/effect/turf_decal/trimline/nk006/dep_support/filled,
/turf/open/floor/iron/white/smooth_large,
/area/shuttle/escape)
"R" = (
/obj/structure/window/reinforced{
	dir = 1
	},
/obj/machinery/door/window/right/directional/east{
	req_access = list("nk006_security")
	},
/obj/effect/turf_decal/trimline/nk006/sub_blue/filled/end{
	dir = 1
	},
/turf/open/floor/iron/dark,
/area/shuttle/escape)
"S" = (
/obj/structure/chair/comfy/shuttle{
	dir = 8
	},
/obj/structure/extinguisher_cabinet/directional/south,
/turf/open/floor/iron,
/area/shuttle/escape)
"V" = (
/turf/open/floor/iron,
/area/shuttle/escape)
"W" = (
/obj/structure/window/reinforced{
	dir = 4
	},
/obj/structure/table/optable,
/obj/effect/turf_decal/tile/nk006/department_sub_red/fourcorners,
/turf/open/floor/iron/white,
/area/shuttle/escape)
"Y" = (
/obj/machinery/light/directional/north,
/obj/structure/window/reinforced{
	dir = 4
	},
/obj/structure/chair/office{
	dir = 8
	},
/obj/effect/turf_decal/trimline/nk006/sub_yellow/filled/end{
	dir = 1
	},
/turf/open/floor/iron/dark/smooth_large,
/area/shuttle/escape)
"Z" = (
/obj/machinery/door/window/right/directional/east{
	req_access = list("nk006_head_any")
	},
/obj/effect/turf_decal/trimline/nk006/sub_yellow/filled/line{
	dir = 4
	},
/obj/effect/turf_decal/trimline/nk006/sub_yellow/filled/line{
	dir = 8
	},
/turf/open/floor/iron/dark/smooth_large,
/area/shuttle/escape)

(1,1,1) = {"
c
a
a
a
a
a
c
"}
(2,1,1) = {"
a
d
O
z
L
K
a
"}
(3,1,1) = {"
N
Y
Z
q
R
p
N
"}
(4,1,1) = {"
N
M
V
V
V
S
N
"}
(5,1,1) = {"
x
V
V
w
V
V
x
"}
(6,1,1) = {"
N
A
V
w
V
o
N
"}
(7,1,1) = {"
x
V
V
w
V
V
x
"}
(8,1,1) = {"
N
k
Q
l
t
F
N
"}
(9,1,1) = {"
N
N
f
C
W
N
N
"}
(10,1,1) = {"
n
b
c
c
c
n
b
"}
(11,1,1) = {"
J
E
s
u
H
J
E
"}
